1111111111111
1001000CC00C1
1000011111001
1P0C11E000001
1111111111111
